353,354,355,356,353,354,355,356,353,354,355,356,353,354,355,356,353,354,355,356,353,354,355,356,353,354,355,356,353,354
385,386,387,388,385,386,387,388,385,386,387,388,385,386,387,388,385,386,387,388,385,386,387,388,385,386,387,388,385,386
417,418,419,420,417,418,419,420,417,418,419,420,417,418,419,420,417,418,419,420,417,418,419,420,417,418,419,420,417,418
353,354,355,356,353,354,355,356,353,354,355,356,353,354,355,356,353,354,355,356,353,354,355,356,353,354,355,356,353,354
385,386,387,388,385,386,387,388,385,386,387,388,385,386,387,388,385,386,387,388,385,386,387,388,385,386,387,388,385,386
12,12,12,13,14,15,419,420,417,418,419,420,417,418,419,420,417,418,419,420,417,418,419,420,417,418,419,420,417,418
44,44,12,12,12,13,14,15,353,354,355,356,353,354,355,356,353,354,355,356,353,354,355,356,353,354,355,356,353,354
76,76,44,44,12,12,13,14,15,386,387,388,385,386,387,388,385,386,387,388,385,386,387,388,385,386,387,388,385,386
108,108,76,76,44,12,12,13,14,15,419,420,417,418,419,420,417,418,419,420,417,418,419,420,417,418,419,420,417,418
353,354,108,108,76,44,12,12,13,14,15,356,353,354,355,356,353,354,355,356,353,354,355,356,353,354,355,356,353,354
385,386,387,388,108,76,44,12,12,13,14,15,385,386,387,388,385,386,387,388,385,386,387,388,385,386,387,388,385,386
417,418,419,420,417,108,76,44,12,12,13,14,15,418,419,420,417,418,419,420,417,418,419,420,417,418,419,420,417,418
353,354,355,356,353,354,108,76,44,12,12,13,14,15,355,356,353,354,355,356,353,354,355,356,353,354,355,356,353,354
385,386,387,388,385,386,387,108,76,44,12,12,13,14,15,388,385,386,387,388,385,386,387,388,385,386,387,388,385,386
417,418,419,420,417,418,419,420,108,76,44,12,12,13,14,15,417,418,419,420,417,418,419,420,417,418,419,420,417,418
353,354,355,356,353,354,355,356,353,108,76,44,12,12,13,14,15,354,355,356,353,354,355,356,353,354,355,356,353,354
385,386,387,388,385,386,387,388,385,386,108,76,44,12,12,13,14,15,387,388,385,386,387,388,385,386,387,388,385,386
417,418,419,420,417,418,419,420,417,418,419,108,76,44,12,12,12,13,14,15,417,418,419,420,417,418,419,420,417,418
353,354,355,356,353,354,355,356,353,354,355,356,108,76,44,44,12,12,12,13,14,15,355,356,353,354,355,356,353,354
385,386,387,388,385,386,387,388,385,386,387,388,385,108,76,76,44,44,12,12,13,14,15,388,385,386,387,388,385,386
417,418,419,420,417,418,419,420,417,418,419,420,417,418,108,108,76,76,44,12,12,13,14,15,417,418,419,420,417,418
353,354,355,356,353,354,355,356,353,354,355,356,353,354,355,356,108,108,76,44,12,12,12,13,14,15,355,356,353,354
385,386,387,388,385,386,387,388,385,386,387,388,385,386,387,388,385,386,108,76,44,44,12,12,13,14,15,388,385,386
417,418,419,420,417,418,419,420,417,418,419,420,417,418,419,420,417,418,419,108,76,76,44,12,12,13,14,15,417,418
353,354,355,356,353,354,355,356,353,354,355,356,353,354,355,356,353,354,355,356,108,108,76,44,12,13,14,15,353,354
385,386,387,388,385,386,387,388,385,386,387,388,385,386,387,388,385,386,387,388,385,386,108,76,12,12,13,14,15,386
417,418,419,420,417,418,419,420,417,418,419,420,417,418,419,420,417,418,419,420,417,418,419,108,44,12,12,13,14,15
353,354,355,356,353,354,355,356,353,354,355,356,353,354,355,356,353,354,355,356,353,354,355,356,76,44,12,13,14,15
385,386,387,388,385,386,387,388,385,386,387,388,385,386,387,388,385,386,387,388,385,386,387,388,108,76,44,45,46,47
417,418,419,420,417,418,419,420,417,418,419,420,417,418,419,420,417,418,419,420,417,418,419,420,417,108,76,77,78,79
